100
38
#.####################################
#.##################.#################
#......#######.#####......#######.####
#.####.##......#####.####.##......####
#.####.##.####.#####.####.##.####.####
#..................#.#........#.......
#.####.####.####.###.####.####.####.##
#.####.####.####.###.####.####.####.##
#......##.....##...#.#....##.....##...
######.####.########.####.####.#######
####........########.##........#######
######.####.###....#.#########.#######
######......###.##...####......#######
###########......####...######.#######
#####################.#..#...#.#######
#......................#...#...#######
#.####################################
#.####################################
#.##################.#################
#......#######.#####......#######.####
#.####.##......#####.####.##......####
#.####.##.####.#####.####.##.####.####
#..................#.#........#.......
#.####.####.####.###.####.####.####.##
#.####.####.####.###.####.####.####.##
#......##.....##...#.#....##.....##...
######.####.########.####.####.#######
####........########.##........#######
######.####.###....#.#########.#######
######......###.##...####......#######
###########......####...######.#######
#####################.#..#...#.#######
#......................#...#...#######
#.####################################
#.####################################
#.##################.#################
#......#######.#####......#######.####
#.####.##......#####.####.##......####
#.####.##.####.#####.####.##.####.####
#..................#.#........#.......
#.####.####.####.###.####.####.####.##
#.####.####.####.###.####.####.####.##
#......##.....##...#.#....##.....##...
######.####.########.####.####.#######
####........########.##........#######
######.####.###....#.#########.#######
######......###.##...####......#######
###########......####...######.#######
#####################.#..#...#.#######
#......................#...#...#######
#.####################################
#.####################################
#.##################.#################
#......#######.#####......#######.####
#.####.##......#####.####.##......####
#.####.##.####.#####.####.##.####.####
#..................#.#........#.......
#.####.####.####.###.####.####.####.##
#.####.####.####.###.####.####.####.##
#......##.....##...#.#....##.....##...
######.####.########.####.####.#######
####........########.##........#######
######.####.###....#.#########.#######
######......###.##...####......#######
###########......####...######.#######
#####################.#..#...#.#######
#......................#...#...#######
#.####################################
#.####################################
#.##################.#################
#......#######.#####......#######.####
#.####.##......#####.####.##......####
#.####.##.####.#####.####.##.####.####
#..................#.#........#.......
#.####.####.####.###.####.####.####.##
#.####.####.####.###.####.####.####.##
#......##.....##...#.#....##.....##...
######.####.########.####.####.#######
####........########.##........#######
######.####.###....#.#########.#######
######......###.##...####......#######
###########......####...######.#######
#####################.#..#...#.#######
#......................#...#...#######
#.####################################
#.####################################
#.##################.#################
#......#######.#####......#######.####
#.####.##......#####.####.##......####
#.####.##.####.#####.####.##.####.####
#..................#.#........#.......
#.####.####.####.###.####.####.####.##
#.####.####.####.###.####.####.####.##
#......##.....##...#.#....##.....##...
######.####.########.####.####.#######
####........########.##........#######
######.####.###....#.#########.#######
######......###.##...####......#######
###########......####...######.#######
#####################.#..#...#.#######
#......................#...#...#######
#.####################################
1  
3763
