14
19
#.#################
#.#################
#......#######.####
#.####.##......####
#.####.##.####.####
#..................
#.####.####.####.##
#.####.####.####.##
#......##.....##...
######.####.#######
####........#######
######.####.#######
######......#######
###########.#######
1  
258
